????????????????????????????????????????????????????????????????????????????????????????????????????????????????????????????????????????????????????????????????????????????????????????????????????????
?????????????????????????????????????????????????????????????????????????????????????????KK?????????????????????????????????????????????????????????????????????????????????????????????????????????????
????????????????????????????????????????????????????????????????????????????????????????????????????????????????????????????????????????????????????????????????????????????????????????????????????????
?????????????????????????????????????????????????????????????????????????????????????????ii?????????????????????????????????????????????????????????????????????ddd?????????????????????????????????????
?????????????????????????????????????????????????????????????????????????????HKKH??????????????????HKKH?????????????????????????????????????????????????????????????ii????????f?????????????????????????
????????????????????????????????????????????????????????????????????????????????????????PPPP????????????????????????????????????????????????????????????????P???P?PPP?P???PPP??P??PP?PP?PPP?????????????
???????????????????????????????????????????????????????????????????????????????????????P?MM?P???????????????????????????????????????????????????????????????P???P?P???P???P?P?P?P?P?P?P?P???????????????
??????????????????????????????????????????????QQQQP?????????????E?????????????????????P??MM??P??????????????????????????????????????????????????????????????P???P?PPP?P???P???P?P?P???P?PPP?????????????
??????????????????????????????????????????????????PP???????????HHH???????????PPPP?????P?P??P?P?????PPPP???????????????RRR?HH????????????????????????????PPPPP?P?P?P???P???P?P?P?P?P???P?P????PPPPPPPPPPP
?????????????????????K????????PPP??PP??P?PPP???????PP???????????e???????????????????P?P??????P?P??????????????e???????R?R?????????????????????????????PPPP???P?P??PPP?PPP?PPP??P??P???P?PPP??P?????????P
??????????????????????????????P????P?PHPHP??????e???PP??????K???????????????????????P??P?PP?P??P?????????????HHH?????RR??j??????iiiiiii???HH????K???PPPP??????????????????f??????????????????P?????????P
?????????????????????????PPP??P????P?PHPHP?????HHH???PP??????????????dd????????????PP???P??P???PP???????????RRRR?????R????jPP????????????PPPP??PPP????????????????????????H??????????????????PPPPP?????P
??????????????????????????????P????P?PHPHP????????????PP????????????????????????????????P??P?????j??????????R??R????RR??????????????????????????????????dddd????????KKKK???H??KKKKHH???H???HH??HHP?????P
????????????????????P?P?j?????PPP??PP??P?PPP???????????PP?????????????????????????a??????PP????????????????RR??RR???R??????????????ff???????????????????????????????HHHHHHHHH?????H?H?H?H?H???H??P?????P
PP???????????k?????????????????????????f??k?????P???????PP???????????????????????PPP????????????????????RR????????RRR???j?j???????f??f??????????PPPPP??????????????????????H??????HH??H?H??H???H?P????VP
??P???????????????PP?j????dd?????PHHKK???KKHH??P?P?j?????PPP???????P?????????k???PPP?P????????????PP???????????k???????j?j???????????????????PPPPPPPP????????f????k??f????????????H?H?H?H???H???H?????WP
???P?????????????PP???????????????HHH?????HHH?P???P?j??????P??????P?P???????P????PPP?????hh???a?j??PP???e?HHHH?????????????j?????j????????PPPPPPPPPP????????????????????PPPPPPP???????????????????????PP
????P??????????????????????????????????e?????????????j????PP??????????????P?P???PPP?PPjPPPPPPPPP???PPP?????P?PPPPP???????????PPPP??PPPPPPPPPPPPPPPPP?????????j????????PQQQQQQPPPP????PPPPPPPPPPPPPPPPPP
?????PPPPPPPPPPPP????????????????jQQQQQQQQQ?Q???????????????PPP?j?PPPP??PPPPPP??P?????????????????????????????????PPPPPP????????????PPPPPPPPPPPPPPPPPPPP??PPP??P??PPP??PQQQQQQ?PP????PPPPPPPPPPPPPPPPPpP
??????????????????????????????????QQQQQQQQ??Q???????????????????????????????????????????????????????????????????????????????????????????????????????PPPP??PPP?????PPPP?P???????????????????????????????P